21,21
+++++++++++++++++++++
+s    + +     + +   +
+ +++ + + +++ + + +++
+   +       +   + + +
+ + +++ +++++++ + + +
+ +   + + + +       +
+++++ +++ + + +++++ +
+     +   +     + + +
+ +++++ +++++++ + +++
+     + +   +   + + +
+ +++++ +++ + +++ + +
+ +     +       +   +
+ + +++++ +++++++ + +
+     + +       + + +
+ + +++ + + + + + + +
+ +   + + + + +   + +
+++++++ +++ +++++ +++
+   +     +   +     +
+++ +++++ + +++ +++ +
+           +   +g  +
+++++++++++++++++++++ 
